9
8
▩▩▩▩▩　　　　
▩♡　　▩　▩▩▩
▩　●●▩　▩♨▩
▩　●　▩▩▩♨▩
▩▩▩　　　　♨▩
　▩　　　▩　　▩
　▩　　　▩▩▩▩
　▩▩▩▩▩　　　