9
9
▩▩▩▩▩　　　　
▩♡　　▩　▩▩▩
▩　●●▩　▩♨▩
▩　●　▩▩▩♨▩
▩▩▩　　　　♨▩
　▩▩　　▩　　▩
　▩　　　▩▩▩▩
　▩▩▩▩▩　　　